NO sprites/BRICK_1A.xpm
WE sprites/BRICK_2A.xpm
SO sprites/BRICK_3A.xpm
EA sprites/BRICK_4A.xpm
DO sprites/DOOR_2A.xpm


F 220,100,0
C 225,30,0

        1111111111111111111111111
        1000000000110000000000001
        1111000001110000000000001
        1001000000200000000000001
111111111011000001110000000000001
100000000011000001112111111111111
11110111111111011100000010001
11112111111111211101010010001
11000000110101011100000010001
10000000000000001100000020001
10000000000000001101010010001
11000001110101011111011110N01
11110111 1110101 101111010001
11111111 1111111 111111111111
