NO sprites/BRICK_1A.xpm

WE sprites/BRICK_2A.xpm

SO sprites/BRICK_3A.xpm



EA sprites/BRICK_4A.xpm


DO sprites/DOOR_2A.xpm
F  128,128,128



C  0,255,255

11111
1S021
10101
12001
11111 
