1111111111111111111111111111111111
1E0000000X00000C00000C000000000001
1010010100100000101001000X00010101
101001001010101000100100X000010101
1P0000000C00C00000X0000000X00000C1
1000C00C00000000000000000011111111
1001001010101000100100000001000101
1E0000X00000000C00000C000000000001
10000C00C00000000X0000000011110001
1000C00C0000000000X000000000010C11
1000C00C000000000X0000000011111111
10000C00C0000000000000X00000001111
1001001010101000100100000001011011
1E0000X00000000C00000C0000X0000001
1000C00C00000000000000000000111011
1001001010101000100100000001011101
1E00000X0000000C00000C0000X0000001
1000C00C00000000000000000011111111
1001001010101000100100000001011001
1000C00C0000000X00000X000011111111
1E00X00X0000000C00000C0000X0000001
1001001010101000100100X000010CC001
1111111111111111111111111111111111