1111111111111111111111111111111111
10X000000000X00C00000C00000X000001
100E010100100000101001000000010101
1000010010101010001001000000010101
1P0000000C00C000000000000X000000C1
1111111111111111111111111111111111