1111111111111111111111111111111111
1E0000000000000C00000C000000000001
1010011100100001111011111000011101
1111110011111110001101000111110111
1P0000000C00C0000000000000000000C1
1111111111111111111111111111111111